S ############
#    ###### ##
# ##    # # ##
# ## ## #   ##
# ##  #   #  #
# ## ## #### #
# ##         #
# ## ### ### #
#      #   # #
##### #### # E
