###############
#S  #   #######
# # #   # # ###
# # # # #   ###
# #   #   #  ##
# ### # # ## ##
# #     #    ##
# ##### #### ##
#            E#
###############