##########
#S   # # #    
# #      #
###  # # #
#     ## #
## #######
#       E#
##########