##########
#S   # # #    
#  #     #
#### # # #
#    #   #
#### # # #
#       E#
##########