###############
#S  #       ###
# # #   ### ###
# # # # #   ###
# #   ##  #  ##
# ##### # #####
#       #    ##
############ ##
#            E#
###############