##########
#S   # # #    
# #  #   #
###  ### #
#     #  #
## ## ## #
#       E#
##########