##########
#S   #   #    
#  # # # #
## ### # #
#      # #
### #### #
#       E#
##########